have (a child)	います
stay be (in japan)	います
take (referring to time or money)	かかります
take a day off (work)	やすみます
apple	りんご
mandarin orange	みかん
sandwitch	サンドイッチ
curry (and rice)	カレーライス
ice cream	アイスクリーム
postage stamp	きって
post card	はがき
envelope	ふうとう
special delivery	そくたつ
registered mail	かきとめ
airmail	エアメール
sea mail	ふなびん
parents	りょうしん
brothers and sisters	きょうだい
my - elder brother	あに
someone else's elder brother	おにいさん
my - elder sister	あね
someone else's - elder sister	おねえさん
my younger brother	おとうと
someone else's younger brother	おとうとさん
my younger sister	いもうと
someone else's younger sister	いもうとさん
foreign country	がいこく
- hours	じかん
- weeks	しゅうかん
- months	かげつ
- years	ねん
about ~	～ぐらい
how long	どのくらい
in total	ぜんぶで
all, everything	みんな
only~	だけ
welcome./May i help you	いらっしゃいませ
nice weather, isn't it?	いい　おてんきですね
are you going out？	おでかけですか
I'm just going to~	ちょっと～まで
so long	いっていらっしゃい
so long (I'm　going and coming back)	いってまいります
and, furthermore	それから